"","cod_category","Few","Many","None","all_passing"
"1","covid_19",9,17,28,26
"2","drug_alcohol",7,0,47,7
"3","execution",6,4,44,10
"4","homicide",16,8,30,24
"5","homicide_by_leo",3,1,50,4
"6","natural",7,9,38,16
"7","pending",7,2,45,9
"8","suicide",11,12,31,23
"9","uninten_non_drug_inj",4,1,49,5
"10","unknown",16,17,21,33
